___________
___####____
##______###
___###_____
___#_#_____
__#########
______##___
#_#_#____##
__#_#_##___
__#########
